20 18
TERRAIN
.. TRUE TRUE sprites.png 5 3
WW FALSE FALSE sprites.png 7 2
END TERRAIN
START
........................................
..WWWWWW....WWWWWW....WWWWWW....WWWWWW..
..WW............WW....WW............WW..
..WW....WWWW....WW....WW....WWWW....WW..
..WW............WW....WW............WW..
..WW..WWWWWWWW..WW....WW..WWWWWWWW..WW..
..WW............WW....WW............WW..
....WWWW....WWWW........WWWW....WWWW....
........................................
........................................
..WWWWWW....WWWWWW....WWWWWW....WWWWWW..
..WW............WW....WW............WW..
..WW....WWWW....WW....WW....WWWW....WW..
..WW............WW....WW............WW..
..WW..WWWWWWWW..WW....WW..WWWWWWWW..WW..
..WW............WW....WW............WW..
....WWWW....WWWW........WWWW....WWWW....
........................................
END
UNITS
aa TRUE
bb FALSE
END UNITS
START
######aaaaaaaa############aaaaaaaa######
########################################
########################################
########################################
########################################
########################################
########################################
########################################
######bbbbbbbb############bbbbbbbb######
######aaaaaaaa############aaaaaaaa######
########################################
########################################
########################################
########################################
########################################
########################################
########################################
######bbbbbbbb############bbbbbbbb######
END
